16 48
483 1346
091 091 091 091 091 091 091 091 091 091 091 091 091 091 091 091
091 091 091 091 091 091 091 091 091 091 091 091 091 091 091 091
091 091 091 091 091 091 091 091 091 091 091 091 091 091 091 091
091 091 093 093 093 093 093 093 093 093 093 093 093 093 091 091 
091 091 093 093 093 093 093 093 093 093 093 093 093 093 091 091 
091 091 093 093 093 093 093 093 093 093 093 093 093 093 091 091 
091 091 093 093 093 093 093 093 093 093 093 093 093 093 091 091 
091 091 091 091 091 091 091 091 091 091 091 091 094 095 091 091 
091 091 091 091 091 091 091 091 091 091 091 091 094 095 091 091 
091 091 091 091 091 091 091 091 091 091 091 091 094 095 091 091 
091 091 093 093 093 093 093 093 093 093 093 093 094 095 091 091 
091 091 093 093 093 093 093 093 093 093 093 093 093 093 091 091 
091 091 093 093 093 093 093 093 093 093 093 093 093 093 091 091 
091 091 093 093 093 093 093 093 093 093 093 093 093 093 091 091
091 091 091 091 091 091 091 091 091 091 091 091 094 095 091 091 
091 091 091 091 091 091 091 091 091 091 091 091 094 095 091 091 
091 091 091 091 091 091 091 091 091 091 091 091 094 095 091 091
091 091 093 093 093 093 093 093 093 093 093 093 094 095 091 091  
091 091 093 093 093 093 093 093 093 093 093 093 093 093 091 091  
091 091 093 093 093 093 093 093 093 093 093 093 093 093 091 091  
091 091 093 093 093 093 093 093 093 093 093 093 093 093 091 091  
091 091 093 093 093 093 093 096 097 093 093 093 093 093 091 091    
091 091 091 091 091 091 091 091 091 091 091 091 091 091 091 091
091 091 091 091 091 091 091 091 091 091 091 091 091 091 091 091
091 091 091 091 091 091 091 091 091 091 091 091 091 091 091 091
091 091 091 091 091 091 091 091 091 091 091 091 091 091 091 091
091 091 091 091 091 091 091 091 091 091 091 091 091 091 091 091
091 091 091 091 093 093 093 093 093 093 093 093 091 091 091 091
091 091 091 091 093 093 093 093 093 093 093 093 091 091 091 091
091 091 091 091 093 093 093 093 093 093 093 093 091 091 091 091
091 091 091 091 093 093 093 093 093 093 093 093 091 091 091 091
091 091 091 091 093 093 093 093 093 093 093 093 091 091 091 091
091 091 091 091 093 093 093 096 097 093 093 093 091 091 091 091
091 091 091 091 091 091 091 091 091 091 091 091 091 091 091 091
091 091 091 091 091 091 091 091 091 091 091 091 091 091 091 091
091 091 091 091 091 091 091 091 091 091 091 091 091 091 091 091
091 091 091 091 091 091 091 091 091 091 091 091 091 091 091 091
091 091 091 091 091 091 091 091 091 091 091 091 091 091 091 091
091 091 091 091 091 091 091 091 091 091 091 091 091 091 091 091
091 091 091 091 091 091 091 091 091 091 091 091 091 091 091 091
091 091 091 091 093 093 093 098 098 098 098 091 091 091 091 091
091 091 091 091 093 093 093 098 098 098 098 091 091 091 091 091
091 091 091 091 093 093 093 093 093 093 093 091 091 091 091 091
091 091 091 091 093 093 093 096 097 093 093 091 091 091 091 091
091 091 091 091 091 091 091 091 091 091 091 091 091 091 091 091
091 091 091 091 091 091 091 091 091 091 091 091 091 091 091 091
091 091 091 091 091 091 091 091 091 091 091 091 091 091 091 091
091 091 091 091 091 091 091 091 091 091 091 091 091 091 091 091
