50 50
860 920
000 000 002 003 004 005 000 000 000 000 000 000 000 000 000 000 000 000 000 000 000 000 000 000 000 000 000 000 000 000 000 000 000 000 0 0 0 0 0 0 0 0 0 0 0 0 0 0 0 0
000 000 006 007 008 009 000 000 000 000 000 000 000 000 000 000 000 000 000 000 000 000 000 000 000 000 000 000 000 000 000 000 000 000 0 0 0 0 0 0 0 0 0 0 0 0 0 0 0 0
000 000 010 011 012 013 000 000 000 000 000 000 000 000 000 000 000 000 000 000 000 000 000 000 000 000 000 000 000 000 000 000 000 000 0 0 0 0 0 0 0 0 0 0 0 0 0 0 0 0
000 000 014 015 016 017 000 000 000 000 000 000 000 000 000 000 000 000 000 000 000 000 000 000 000 000 000 000 000 000 000 000 000 000 0 0 0 0 0 0 0 0 0 0 0 0 0 0 0 0
000 000 002 003 004 005 000 000 000 000 000 000 000 000 000 000 000 000 000 000 000 000 000 000 000 000 000 000 000 000 000 000 000 000 0 0 0 0 0 0 0 0 0 0 0 0 0 0 0 0
000 000 006 007 008 009 000 000 000 000 000 000 000 000 000 000 000 000 000 000 000 000 000 000 000 000 000 000 000 000 000 000 000 000 0 0 0 0 0 0 0 0 0 0 0 0 0 0 0 0
000 000 010 011 012 013 000 000 000 000 000 000 000 000 000 000 000 000 000 000 000 000 000 000 000 000 000 000 000 000 000 000 000 000 0 0 0 0 0 0 0 0 0 0 0 0 0 0 0 0
000 000 014 015 016 017 000 000 000 000 000 000 000 000 000 000 000 000 000 000 000 000 000 000 000 000 000 000 000 000 000 000 000 000 0 0 0 0 0 0 0 0 0 0 0 0 0 0 0 0
036 037 018 019 020 021 034 035 036 037 034 035 036 037 034 035 036 037 034 035 036 037 034 035 036 037 034 035 036 037 034 035 036 037 0 0 0 0 0 0 0 0 0 0 0 0 0 0 0 0
040 041 022 023 024 025 038 039 040 041 038 039 040 041 038 039 040 041 038 039 040 041 022 039 040 025 038 039 040 041 038 039 040 041 0 0 0 0 0 0 0 0 0 0 0 0 0 0 0 0
044 045 026 027 028 029 042 043 044 045 042 043 044 045 042 043 044 045 042 043 044 045 026 027 028 029 042 043 044 045 042 043 044 045 0 0 0 0 0 0 0 0 0 0 0 0 0 0 0 0
048 049 030 031 032 033 046 047 048 049 046 047 048 049 046 047 048 049 046 047 048 049 030 031 032 033 046 047 048 049 046 047 048 049 0 0 0 0 0 0 0 0 0 0 0 0 0 0 0 0
000 000 002 003 004 005 082 083 083 083 083 083 083 083 083 083 083 083 083 083 083 084 002 003 004 005 082 083 083 083 083 083 083 083 0 0 0 0 0 0 0 0 0 0 0 0 0 0 0 0
000 000 006 007 008 009 085 000 000 000 001 001 001 001 001 001 001 001 000 000 000 087 006 007 008 009 085 000 000 000 000 000 000 000 0 0 0 0 0 0 0 0 0 0 0 0 0 0 0 0
000 000 010 011 012 013 085 000 000 000 001 001 001 001 001 001 001 001 000 000 000 087 010 011 012 013 085 000 000 000 000 000 000 000 0 0 0 0 0 0 0 0 0 0 0 0 0 0 0 0
000 000 014 015 016 017 088 089 089 089 089 089 089 089 089 089 089 089 089 089 089 090 014 015 016 017 088 089 089 089 089 089 089 089 0 0 0 0 0 0 0 0 0 0 0 0 0 0 0 0
000 000 002 075 020 021 034 035 036 037 034 035 036 037 034 035 036 037 034 035 036 037 018 019 020 021 034 035 036 037 034 035 036 037 0 0 0 0 0 0 0 0 0 0 0 0 0 0 0 0
000 000 006 007 056 025 038 039 040 041 038 039 040 041 038 039 040 041 038 039 040 041 022 055 056 025 038 039 040 041 038 039 040 041 0 0 0 0 0 0 0 0 0 0 0 0 0 0 0 0
000 000 010 011 060 029 042 043 044 045 042 043 044 045 042 043 044 045 042 043 044 045 068 043 044 072 042 043 044 045 042 043 044 045 0 0 0 0 0 0 0 0 0 0 0 0 0 0 0 0
000 000 014 079 032 033 046 047 048 049 046 047 048 049 046 047 048 049 046 047 048 049 046 047 048 049 046 047 048 049 046 047 048 049 0 0 0 0 0 0 0 0 0 0 0 0 0 0 0 0
000 000 002 003 004 005 082 083 083 083 083 083 083 083 083 083 083 083 083 083 083 083 083 083 083 083 083 083 083 083 083 083 083 083 0 0 0 0 0 0 0 0 0 0 0 0 0 0 0 0
000 000 006 007 008 009 085 000 000 000 000 000 000 000 000 000 000 000 000 000 001 001 001 001 001 001 001 001 001 001 001 001 001 001 0 0 0 0 0 0 0 0 0 0 0 0 0 0 0 0
000 000 010 011 012 013 085 000 000 000 000 000 000 000 000 000 000 000 000 000 001 001 001 001 001 001 001 001 001 001 001 001 001 001 0 0 0 0 0 0 0 0 0 0 0 0 0 0 0 0
000 000 014 015 016 017 088 089 089 089 089 089 089 089 089 089 089 089 089 089 089 089 089 089 089 089 089 089 089 089 089 089 089 089 0 0 0 0 0 0 0 0 0 0 0 0 0 0 0 0
000 000 002 075 020 021 034 035 036 037 034 035 036 037 034 035 036 037 034 035 036 037 034 035 036 037 034 035 036 037 034 035 036 037 0 0 0 0 0 0 0 0 0 0 0 0 0 0 0 0
000 000 006 007 056 025 038 039 040 041 038 039 040 041 038 039 040 041 038 039 040 041 038 039 040 041 038 039 040 041 038 039 040 041 0 0 0 0 0 0 0 0 0 0 0 0 0 0 0 0
000 000 010 011 060 029 042 043 044 045 042 043 044 045 042 043 044 045 042 043 044 045 042 043 044 045 042 043 044 045 042 043 044 045 0 0 0 0 0 0 0 0 0 0 0 0 0 0 0 0
000 000 014 079 032 033 046 047 048 049 046 047 048 049 046 047 048 049 046 047 048 049 046 047 048 049 046 047 048 049 046 047 048 049 0 0 0 0 0 0 0 0 0 0 0 0 0 0 0 0
000 000 002 003 004 005 000 000 000 000 000 000 000 000 000 000 000 000 000 000 000 000 000 000 000 000 000 000 000 000 000 000 000 000 0 0 0 0 0 0 0 0 0 0 0 0 0 0 0 0
000 000 006 007 008 009 00 0 0 0 0 0 0 0 0 0 0 0 0 0 0 0 0 0 0 00 00 0 0 0 0 0 0 0 0 0 0 0 0 0 0 0 0 0 0 0 0 0 0 0
000 000 010 011 012 013 0 0 0 0 0 0 0 0 0 0 0 0 0 0 0 0 0 0 0 00 00 0 0 0 0 0 0 0 0 0 0 0 0 0 0 0 0 0 0 0 0 0 0 0
000 000 014 015 016 017 0 0 0 0 0 0 0 0 0 0 0 0 0 0 0 0 0 0 0 00 00 0 0 0 0 0 0 0 0 0 0 0 0 0 0 0 0 0 0 0 0 0 0 0
00 00 00 00 0 0 0 0 0 0 0 0 0 0 0 0 0 0 0 0 0 0 0 0 0 00 00 0 0 0 0 0 0 0 0 0 0 0 0 0 0 0 0 0 0 0 0 0 0 0
00 00 00 00 0 0 0 0 0 0 0 0 0 0 0 0 0 0 0 0 0 0 0 0 0 00 00 0 0 0 0 0 0 0 0 0 0 0 0 0 0 0 0 0 0 0 0 0 0 0
00 00 00 00 0 0 0 0 0 0 0 0 0 0 0 0 0 0 0 0 0 0 0 0 0 00 00 0 0 0 0 0 0 0 0 0 0 0 0 0 0 0 0 0 0 0 0 0 0 0
00 00 00 00 0 0 0 0 0 0 0 0 0 0 0 0 0 0 0 0 0 0 0 0 0 00 00 0 0 0 0 0 0 0 0 0 0 0 0 0 0 0 0 0 0 0 0 0 0 0
00 00 00 00 0 0 0 0 0 0 0 0 0 0 0 0 0 0 0 0 0 0 0 0 0 00 00 0 0 0 0 0 0 0 0 0 0 0 0 0 0 0 0 0 0 0 0 0 0 0
00 00 00 00 0 0 0 0 0 0 0 0 0 0 0 0 0 0 0 0 0 0 0 0 0 00 00 0 0 0 0 0 0 0 0 0 0 0 0 0 0 0 0 0 0 0 0 0 0 0
00 00 00 00 0 0 0 0 0 0 0 0 0 0 0 0 0 0 0 0 0 0 0 0 0 00 00 0 0 0 0 0 0 0 0 0 0 0 0 0 0 0 0 0 0 0 0 0 0 0
00 00 00 00 0 0 0 0 0 0 0 0 0 0 0 0 0 0 0 0 0 0 0 0 0 00 00 0 0 0 0 0 0 0 0 0 0 0 0 0 0 0 0 0 0 0 0 0 0 0
00 00 00 00 0 0 0 0 0 0 0 0 0 0 0 0 0 0 0 0 0 0 0 0 0 00 00 0 0 0 0 0 0 0 0 0 0 0 0 0 0 0 0 0 0 0 0 0 0 0
00 00 00 00 0 0 0 0 0 0 0 0 0 0 0 0 0 0 0 0 0 0 0 0 0 00 00 0 0 0 0 0 0 0 0 0 0 0 0 0 0 0 0 0 0 0 0 0 0 0
00 00 00 00 0 0 0 0 0 0 0 0 0 0 0 0 0 0 0 0 0 0 0 0 0 00 00 0 0 0 0 0 0 0 0 0 0 0 0 0 0 0 0 0 0 0 0 0 0 0
00 00 00 00 0 0 0 0 0 0 0 0 0 0 0 0 0 0 0 0 0 0 0 0 0 00 00 0 0 0 0 0 0 0 0 0 0 0 0 0 0 0 0 0 0 0 0 0 0 0
00 00 00 00 0 0 0 0 0 0 0 0 0 0 0 0 0 0 0 0 0 0 0 0 0 00 00 0 0 0 0 0 0 0 0 0 0 0 0 0 0 0 0 0 0 0 0 0 0 0
00 00 00 00 0 0 0 0 0 0 0 0 0 0 0 0 0 0 0 0 0 0 0 0 0 00 00 0 0 0 0 0 0 0 0 0 0 0 0 0 0 0 0 0 0 0 0 0 0 0
00 00 00 00 0 0 0 0 0 0 0 0 0 0 0 0 0 0 0 0 0 0 0 0 0 00 00 0 0 0 0 0 0 0 0 0 0 0 0 0 0 0 0 0 0 0 0 0 0 0
00 00 00 00 0 0 0 0 0 0 0 0 0 0 0 0 0 0 0 0 0 0 0 0 0 00 00 0 0 0 0 0 0 0 0 0 0 0 0 0 0 0 0 0 0 0 0 0 0 0
00 00 00 00 0 0 0 0 0 0 0 0 0 0 0 0 0 0 0 0 0 0 0 0 0 00 00 0 0 0 0 0 0 0 0 0 0 0 0 0 0 0 0 0 0 0 0 0 0 0
00 00 00 00 0 0 0 0 0 0 0 0 0 0 0 0 0 0 0 0 0 0 0 0 0 00 00 0 0 0 0 0 0 0 0 0 0 0 0 0 0 0 0 0 0 0 0 0 0 0